111111111111111111111111111111111111111111111111112
1e0000000000000000000000100000000000000000000000012
111111111111111111111110111111111111111111111111012
100000000000100000000000100000000000000000000000012
101111111111111101111111111111111111111111111111112
100000000010000000000000000000000000000000000000012
111110111111111111111111111110111111111111111111012
100000000000000000000000000000000000010000000000012
101111111111111111011111111111111111111111111111112
100000000000000000000000000000000000000000000000012
111111111101111111111111111111111101111111111111012
100000000000000000000000000000000000000000100000012
101111111111111111110111111111111111111111111011112
100000000000000000000000000100000000000000000000012
111111111111101111111111111111111111111111111111012
100000001000000000000000000000000100000000000000012
101111111111111111110111111111111111111011110111112
100000000000000000000000000000000000000011110000012
111111111111111111111111111111111111111111111111s12
111111111111111111111111111111111111111111111111112
