111111111111111111111111111111111111111111111111112
1e0000000000000000000000000000000000000000000000012
111111111111111111111111111111111111111111111111012
100000000000000000000000000000000000000000000000012
101111111111111111111111111111111111111111111111112
100000000000000000000000000000000000000000000000012
111111111111111111111111111111111111111111111111012
100000000000000000000000000000000000000000000000012
101111111111111111111111111111111111111111111111112
100000000000000000000000000000000000000000000000012
111111111111111111111111111111111111111111111111012
100000000000000000000000000000000000000000000000012
101111111111111111111111111111111111111111111111112
100000000000000000000000000000000000000000000000012
111111111111111111111111111111111111111111111111012
100000000000000000000000000000000000000000000000012
101111111111111111111111111111111111111111111111112
100000000000000000000000000000000000000000000000012
111111111111111111111111111111111111111111111111s12
111111111111111111111111111111111111111111111111112
