11111111111111111111111111111111111111111111111111
12000000000000000000000010000000000000000000000001
11111111111111111111111011111111111111111111111101
10000000000010000000000010000000000000000000000001
10111111111111110111111111111111111111111111111111
10000000001000000000000000000000000000000000000001
11111011111111111111111111111011111111111111111101
10000000000000000000000000000000000001000000000001
10111111111111111101111111111111111111111111111111
10000000000000000000000000000000000000000000000001
11111111110111111111111111111111110111111111111101
10000000000000000000000000000000000000000010000001
10111111111111111111011111111111111111111111101111
10000000000000000000000000010000000000000000000001
11111111111110111111111111111111111111111111111101
10000000100000000000000000000000010000000000000001
10111111111111111111011111111111111111101111011111
10000000000000000000000000000000000000001111000001
11111111111111111111111111111111111111111111111131
11111111111111111111111111111111111111111111111111
