11111111111111111
12111111111111111
10100000000000001
10101111111111101
10100000000003101
10111111111111101
10000000000000001
11111111111111111
