111111111111111111111111111111111111111111111111111111111111
130000000000000000000000000000000000000000000000000000000001
111111111111111111111111111111111111111111111111111111111101
100000100100000000000100010000010001000100000000000000000001
101010100111111111000001000101010111010101111111111111111101
101010100100000100011111111111010111100100000000000000000101
101010100000000101010000000000010000101111111111111111110101
101010000111100101010001111111111110101000000000000000000101
101011111000000101010000000000010110100011111111111111110101
101000000100000001011111111111010000101010000000000000000101
101111110111111111010000000000011100001010111111111111111101
101000000100010000000011111111110101111010000000000000000101
101011111101010020000000001000010101000111111111111111110101
101000000001011111111110000001010001010100000000000000000101
101000111111000000101000111111111101010101111111111111101101
101111100001011100100010000000010001010100000000000000100101
101000001111000100111111111111110101010110101111111111011101
101011100001010100000000000000010101010000100000000001000101
101010001111111111111111111111010101011110111111111110110101
101010000001000000000000000100010101001000000100000000001101
101010011001011110000001000000010101101011111011111111100101
101011001001000010111111111111010101001011000000000000010101
101010001000011010000010000000010101100000111111110111110101
101011111111111111111111111111110101111111100011000101110101
101000000000000000000000000000000100000000001000010000000101
111111111111111111111111111111111111111111111111111111111111
